Stycze
Pielucha - Pierwsza-Pita
Aesthetics 
Teka - III
Dwa Sawy - Ludzie sztosy
Obi - Obrut
Da Vosk Docta - Internet Ghetto III
Ejmatt - Napad na bubel EP
Noize from dust - Ultraakustyka
King TomB x Biaas - BooKING MIXTAPE
Mops & DJ Pete - T.E.N. Mixtape
SB - Czas, bity, mio
Skor - Nadziemie
Ak-47 - Pierwszy dzie w piekle
WAC TOJA - MiDDLE FiNGER
KaeN - Tylko mier moe mnie zatrzyma
Nitro Beatz - Kalejdoskop
O.S.T.R. - Podr zwana yciem
Junes - EP, 5
Bosski Firma - Uliczny przekaz dla dobrych ludzi
Dudek P56 - Polski rap
liwa - Chopak z ssiedztwa
Parzel - Oddech za oddech
Maach - Tempo Mixtape
Pluto NSH  Projekt wilcze zmysy
Popiel/MVZR - REBEL EP
KK - Nowe rzeczy
Wini - Godny duch
Tymin/Peus - Setka Sekta
Duchu/PTK - Linie lotnicze
Quebonafide - Ezoteryka
Quebonafide - Erotyka
Dolar - Serce do lodu
Deys - Imprimatur Mixtape
Otsochodzi - 7
Rover - Sowoplastyka
Sobota x Matheo - Czekajc na Sobot
Peerzet - Oficjalne Wymarcie Krw
Albo Inaczej!
Eskaubei & Tomek Nowak Quartet  Bdzie Dobrze
Rasmentalism - Wyszli co zje
Odgosy Miasta - Da si!
GrubSon - Holizm
Arik - Obsydian EP
Boski Roman - Krak 5
Lucky Dice Radio vol.1
Maolat - Wicej
Theodor - Pierwsze demo
Mielzky / patr00 - Miejski Patrol
Gang Albanii - Krlowie ycia
Krasza - Znikd
Opa/Phonic - Oko
Eripe - Opium
Hyziu x Bogu - Pewuery
Soulpete  R.A.W.
Buka x Skor - Imago
Pikers - piesz si mnie kocha
Czeski - Kolejny Stopie Wtajemniczenia
Trzeci Wymiar  Odmienny Stan wiadomoci
W.E.N.A./Quiz - MONOCHROMY EP
B.R.O - Next level 2
Krvavy - Przeczywisto
VNM - KLAUD N9JN
Da Vosk Docta - Deep Purple Roses EP
DJ Tuniziano & Tede - #Banger_Alert Mixtape
Kacper HTA - Tabula Rasa
Steel Banging - Dwie Strony wiata
T.O.M.S - Hold That Thought
Kieru - Komercja czy underground
Kaz Baagane - LOT 022
Klasiik - Tragiczny MIXTAPE
Bilon BPP aka Joint Penk - 3xNIE
Druyna Mistrzw 3
Juras - Biao-Czerwone Serce
RapFrancuski.pl x Milionbeats - Le Rap Francais vu de la Pologne
RR Brygada - SoundtRRack
Sulin - Taksydermia
Szesnasty - Tego Pan nie poskada
Kontrabanda - Brat Bratu Bratem
Voskovy - Second Hand
Proceente x Bleiz - Aloha Grill
Filipek - Beletrystyka
Sok, Hades, Sampler Orchestra - Rewicz-Interpretacje
Guzior - ylloM
Sarcast - Syn Soca
Tede & Sir Michu - Vanilla Hajs
BonSoul - Lepiej Nie Pyta EP
Bokoty - Nie trzeba mnie namawia
Kociey - TWB Era
Oxon - Supermoce
PMM - W Stron wiata
Taco Hemingway - Umowa o dzieo
Zetenwupe - Bejbo
Kato/MVZR - Umiech Syzyfa
Legendarny Afrojax - Przecie ostrzegaem
abson - Nie kumam
PRO EBT - Esencja bitw tekstw
Hashashins - TA'WIL
Wuzet - Dzieci Basu Level 2
Braddu - Zepsuty dzieciak
Jurek Kiler - Nowy Jurek
Sarius - Gdzie to ju syszaem
Pikers - Bootleg 2015
Hary x Foux - Hary x Foux
Vixen/101 Decybeli - Archiwalnie EP
Ten Typ Mes & DJ Black Belt Greg - Loveyoursongs Mixtape
Leh - Podwrka pytaj kiedy pyta
miech - miech na sali EP
Kartky - Shadowplay
Kartky - Black Magic
Zioo - Cokolwiek
Aberracja
Grizzlee/Dryskull - Stadium Regenesis
KND - Rekonwalescencja EP
TMK aka Piekielny - Abazja
Homex - HX
Diox - Nowy Testament
Syndykat - Syndykator
Pielucha - Trailer
Hukos - Wielkie Wojny Maych Ludzi + Godni z Natury 2.0
Mosad/Kocur - Ludzie - roboty - systemy
Ryfa Ri/Pekro - Miejskie stery
Kuba Knap - Ludzie Mwi Rne Rzeczy
So - BDF
Jeozwierz/O.S.T.R./Soulpete - Growbox
Miuosh - Ulice Bogw
Kajman - 0#1
Mae Miasta - Ko
Zeus - Winda na 5. EP
Zeus - Zeus. Jest super
Hudy HZD - 9000 dni
Popkiller Mode Wilki 4
JWP/BC - Sequel
Te-Tris - Definitywnie
Emes Milligan - Spin-off
Neile - Powidok 94
Buka/Rahim - Optymistycznie
TPS - Wielokrotnie karany
Chester - Cyklon C
liwa & Bandura - El Paso
Empiria - Moja Empiria
Sobota - Sobota
Rabbit - Projekt X EP
KPSN - Pora si wiesza
R.E.S.T. - Wiara, nadzieja, mio
Delekta x Uszer zDP x Nastyk - Micgyver
Deys - TENDAYSEP
Pono - Bunt
2Na - Vortex
DonGuralEsko - Magnum Ignotum (preludium)
Miejski Sort 2 - Gry Wszystkich Miast
Zaburzenia - Igy
Filipek - Fifi. Rozdzia dwudziesty
Fonos - Klasyka Gatunku
Kieru - Swagpunk
Krlowie ycia (Edycja Specjalna)
Prosto -Prosto Mixtape Cztery
Skorup x JazBrothers - ?
ejmatt - Trapped
zey - 50 twarzy zeya
Biaas x Quebonafide - Demwka EP
Biaas - Rehab
Wilkoaki - CzarNaKrew
Lilu - Outro
Tede & Sir Michu - Vanilla Hajs Edycja Premium
Lukasyno - Antybanger
MCC - Amen
Cira - Pocztwki z miasta B.
Slums Attack - Zwyka Codzienno (Reedycja)
Ad.M.a - Gdy skrzyda w popiele, boginie schodz na ziemi
Kartky - Fuego Infinito
Folku x miech - Co innego EP
Tau - Restaurator
Pih - mier i Podatki (single)
Mati x Skor - Nowy porzdek
Bazi x TMK Beatz x DJ Noriz - Czarne wiato
Osiedlowe Linie Lotnicze - Lot Pierwszy
Biaas - Stary Biaas  Bizi Vifon (KLIKKLAKtape)
NNFOF - No Name Fuck The Fame
Theodor - Bez okazji
Solar - Jednak na propsie (ISKRAtape)
Shag - 35 MIXTAPE
Penx - Abstrackt
Ganja Mafia - Wiesz co si krci
W.E.N.A. x Sarius x Voskovy - Ze Towarzystwo EP
DJ Buhh - Volumin 7: Hans Ximer Uwertura
Dj Decks  Mixtape vol.5
Futuryje - Fresh Than Mutherfucker
Kali - Crime Story
Zygson - Sukinkoty EP
TBA
Adamo - Prosto w serce
Bonson - Znany i lubiany
Buczer - Podejrzany o rap vol.4
Cruz/Modzik - ?
Diset - High Definition 3: Drive
Egotrue - ?
Ejmatt/BlaBlady - ? EP
Eldo - Psi
Enson - Kan wa Kan
Eripe/Nastyk - TBA
Fandango Records - ?
Filipek - Noc to pora dla nietoperzy EP
Flint - Smokesex Mixtape
Flojd/Wiro - ?
GPS - 100 Metrw Do Celu EP
Golin - MKW
Green & Gres - Fraktal
Hase - Procesy poznawcze
Hezekiah x Soulpete x Dj Ace - ?
HuczuHucz - ?
HuczuHucz - ? EP
Jotuze/Steven - ?
Karwan x Wiciu - Wybrzee klatki schodowej
Ks. Jakub Bartczak - Po prostu wierz
Kuban - ?
ona i Webber - ?
Mam Na Imi Aleksander - Na wiatach STOP
Matek - ?
Miklak/JarosawBeatz - ?
Mops - Alfabet Mopsa
Muflon - ?
Nerwus - ?
Nullizmatyk  wiat Odwrconego Dekalogu
Numer Raz - Numer kiedy pyta
o2
Ortega Cartel - Benzo
Oxon/Revo - ?
Perki Pat - ?
Pi Dwa - Retro
Pikers x MVZR - ?
PRO8L3M - ?
Pyskaty - Pe???
QueQuality - ?
ReTo - DAMN.
Solar i Biaas - ?
Szad Akrobata  Czowiek Duch
TrzyeM - Back From Da Grave
WDZ - Syn Soca
Wodi x Dj B - Wszystkie drogi prowadz do dymu
Wredny Kozacko - Desert Snow
WuWunio - Szlauf Patrol
Zioo - CO
101 Decybeli - Echo
2016 rok
Popek x Matheo - ?
Mapa - Mwi
Edzio x Filipek - Pyta dekady
Paluch - 10/29
Gang Albanii - Mocarne skurwysyny
WBW All Stars 2015
Borixon - Ko Trojaski
Lanek - Rebel Echo
Pawbeats - ?
Step Records - Rap Najlepszej Marki vol.2
TEDE - LUX_VERITATIS
Bonson x Biaas x Quebonafide - ?
Braddu x RED x Lanek - Rap Baka Lachony
Delekta - ?
Ejmatt - Kolej Rzeczy
Molesta - ?
Tomb x Koldi - ?
